"a" = (/turf/simulated/wall/r_wall,/area/template_noop)
"b" = (/turf/simulated/floor/tiled/techmaint,/area/template_noop)
"c" = (/turf/template_noop,/area/template_noop)
"d" = (/obj/machinery/light{dir = 1},/turf/simulated/floor/tiled/techmaint,/area/template_noop)
"e" = (/obj/random/lowkeyrandom,/turf/simulated/floor/tiled/techmaint,/area/template_noop)
"f" = (/obj/machinery/light{dir = 8; icon_state = "tube1"; pixel_y = 0},/turf/simulated/floor/tiled/techmaint,/area/template_noop)
"g" = (/obj/machinery/light{icon_state = "tube1"; dir = 4},/turf/simulated/floor/tiled/techmaint,/area/template_noop)
"h" = (/obj/machinery/light,/turf/simulated/floor/tiled/techmaint,/area/template_noop)
"i" = (/obj/machinery/door/airlock/maintenance_common{req_access = list(12)},/turf/simulated/floor/tiled/techmaint,/area/template_noop)
"j" = (/obj/machinery/door/airlock/maintenance_common{req_access = list(12)},/turf/simulated/floor/tiled/techmaint,/area/space)

(1,1,1) = {"
aaaaiaaaaaaaiaaaa
accabacccccabacca
accabacccccabacca
aaaabaaaaaaabaaaa
jbbbbbbbdbbbbbbbb
aaaabbbbbbbbbaaaa
accabbebbbebbacca
accabbbbbbbbbacca
accafbbbebbbgacca
accabbbbbbbbbacca
accabbebbbebbacca
aaaabbbbbbbbbaaaa
ibbbbbbbhbbbbbbbb
aaaabaaaaaaabaaaa
accabacccccabacca
accabacccccabacca
aaaabaaaaaaabaaaa
"}
