"a" = (/turf/simulated/wall/r_wall,/area/template_noop)
"b" = (/turf/simulated/floor/tiled/techmaint,/area/template_noop)
"c" = (/obj/machinery/light/small{dir = 1},/turf/simulated/floor/tiled/techmaint,/area/template_noop)
"d" = (/obj/machinery/light{dir = 1},/turf/simulated/floor/tiled/techmaint,/area/template_noop)
"e" = (/obj/machinery/light,/turf/simulated/floor/tiled/techmaint,/area/template_noop)
"f" = (/obj/machinery/light{icon_state = "tube1"; dir = 4},/turf/simulated/floor/tiled/techmaint,/area/template_noop)
"g" = (/obj/machinery/light{dir = 8},/turf/simulated/floor/tiled/techmaint,/area/template_noop)
"h" = (/obj/machinery/light/small{dir = 4; pixel_y = 0},/turf/simulated/floor/tiled/techmaint,/area/template_noop)
"i" = (/obj/machinery/light/small{dir = 8},/turf/simulated/floor/tiled/techmaint,/area/template_noop)
"j" = (/obj/machinery/light/small,/turf/simulated/floor/tiled/techmaint,/area/template_noop)
"k" = (/obj/machinery/door/airlock/maintenance_common{req_access = list(12)},/turf/simulated/floor/tiled/techmaint,/area/template_noop)
"l" = (/obj/machinery/door/airlock/maintenance_common{icon_state = "door_locked"; locked = 1; req_access = list(12)},/turf/simulated/floor/tiled/techmaint,/area/template_noop)

(1,1,1) = {"
aaaakaaaaaaakaaaa
abcbbabbbbbabbdba
abbbbabbbebkbbbba
akaaaabfaaaaaaaba
kbbbbkbbabbbbbabb
akaaaakaabbbbbaba
abbdbabagbbbbfaha
abbbbahabbbbbbaba
abbbbababbbbbbkba
abbebabaaaaakaaba
akaaaakabbbbbbaha
ababcbbagbbbbfaba
kbabbbbbbbbbbbabb
abaaaaaaaaakaaaaa
abbbbkbbbaibblbba
abjbbabjbabbbabja
aaaabaaaaaaabaaaa
"}
